agent_id,age,age_group,occupation,risk_perception,initial_mask_wearing,family_connections,work_school_connections,community_connections,total_connections
0,41,Middle Age,Blue Collar,0.35367665723356584,False,3,4,11,18
1,3,Youth,Blue Collar,0.2485580660782393,False,3,4,12,19
2,13,Youth,Student,0.4159590873381714,True,4,5,13,22
3,38,Young Adult,Student,0.15996757580999196,False,2,4,12,18
4,58,Middle Age,White Collar,0.5502830780616322,False,5,4,11,20
5,19,Young Adult,Blue Collar,0.11094528759339801,False,3,4,18,25
6,27,Young Adult,Student,0.5098966417920571,False,1,5,15,21
7,21,Young Adult,White Collar,0.17727037947274454,False,2,4,13,19
8,27,Young Adult,Blue Collar,0.19829047191334442,False,3,5,14,22
9,31,Young Adult,Student,0.37623678821354994,False,2,4,18,24
10,52,Middle Age,White Collar,0.5434668040445325,False,4,4,20,28
11,7,Youth,Blue Collar,0.08476376294265023,False,3,4,14,21
12,44,Middle Age,White Collar,0.3579287927839609,False,3,2,17,22
13,46,Middle Age,White Collar,0.2733207739503824,False,2,4,19,25
14,40,Young Adult,Blue Collar,0.13437614109485027,False,3,4,10,17
15,7,Youth,Student,0.35325485000480755,False,5,4,15,24
16,80,Elderly,Blue Collar,0.13279012143275798,False,4,4,16,24
17,48,Middle Age,Blue Collar,0.32643436842516804,False,4,5,12,21
18,21,Young Adult,Student,0.1658104012585459,False,3,4,14,21
19,51,Middle Age,Student,0.207734214505591,False,5,4,12,21
20,61,Middle Age,White Collar,0.26340848808284784,False,3,4,14,21
21,36,Young Adult,White Collar,0.39001433036648914,False,3,4,21,28
22,37,Young Adult,White Collar,0.15364547000727538,False,3,4,16,23
23,98,Elderly,White Collar,0.30550235119832064,False,2,4,18,24
24,45,Middle Age,Blue Collar,0.203313881265596,False,3,5,18,26
25,21,Young Adult,White Collar,0.18387687608823067,False,1,4,13,18
26,27,Young Adult,Retired,0.36782408723548077,False,4,4,20,28
27,3,Youth,Blue Collar,0.20209676646387698,False,5,4,15,24
28,39,Young Adult,White Collar,0.18633950452881945,False,2,3,20,25
29,0,Youth,Retired,0.2835202997539891,False,1,5,13,19
30,35,Young Adult,Blue Collar,0.10039930306621214,False,3,3,19,25
31,9,Youth,Blue Collar,0.20772938916523406,False,3,4,12,19
32,11,Youth,Blue Collar,0.3096377073595142,False,2,5,13,20
33,57,Middle Age,Retired,0.0443858001226034,False,1,4,14,19
34,22,Young Adult,Retired,0.12457921344554526,False,2,4,21,27
35,50,Middle Age,Student,0.21100332015818626,False,1,4,13,18
36,21,Young Adult,Student,0.3581887554246956,False,4,5,11,20
37,17,Youth,Blue Collar,0.6522422663601021,False,4,4,17,25
38,36,Young Adult,Student,0.16226602605678067,False,5,4,13,22
39,47,Middle Age,Retired,0.0694242954698856,False,0,4,16,20
40,63,Middle Age,White Collar,0.076848080809821,False,4,4,15,23
41,55,Middle Age,Blue Collar,0.1744335165862888,False,4,5,16,25
42,21,Young Adult,White Collar,0.5434537469656785,False,3,4,11,18
43,26,Young Adult,Student,0.061653913446673224,False,4,3,15,22
44,2,Youth,Retired,0.23568650663126414,False,3,4,11,18
45,7,Youth,White Collar,0.31329412667520323,False,4,4,16,24
46,37,Young Adult,White Collar,0.15258331470398612,False,3,4,22,29
47,32,Young Adult,Student,0.38688633601837824,True,4,4,14,22
48,32,Young Adult,White Collar,0.4845897602554896,False,2,4,15,21
49,3,Youth,Student,0.09593877797328496,False,1,4,13,18
50,44,Middle Age,Student,0.3662241584833629,False,3,4,15,22
51,32,Young Adult,Student,0.29837284269070247,False,4,4,12,20
52,43,Middle Age,White Collar,0.2237663665214278,False,2,5,13,20
53,20,Young Adult,Blue Collar,0.1642916485213648,False,5,4,16,25
54,2,Youth,Retired,0.46138582746288664,False,3,4,15,22
55,15,Youth,White Collar,0.09832146075036968,False,5,4,17,26
56,76,Elderly,White Collar,0.179247512983417,False,5,3,17,25
57,33,Young Adult,White Collar,0.34301873259799726,False,5,4,10,19
58,58,Middle Age,Blue Collar,0.2746698380360602,False,3,5,17,25
59,6,Youth,Retired,0.4432945779277498,False,3,3,13,19
60,29,Young Adult,Student,0.13272443189522465,False,0,4,13,17
61,35,Young Adult,Student,0.4006430877209991,False,3,4,16,23
62,5,Youth,Student,0.32259603850098684,True,1,4,15,20
63,53,Middle Age,Student,0.2923618255131976,False,3,4,11,18
64,38,Young Adult,Student,0.11357697325263676,True,4,4,11,19
65,59,Middle Age,White Collar,0.34155895722546276,False,3,4,11,18
66,29,Young Adult,Student,0.16999587395941756,False,3,4,18,25
67,50,Middle Age,White Collar,0.8014732049023443,False,4,4,16,24
68,66,Elderly,White Collar,0.13177062408757453,False,3,5,14,22
69,70,Elderly,White Collar,0.12549965919150205,False,0,5,18,23
70,11,Youth,Blue Collar,0.3370138954716539,False,5,4,17,26
71,24,Young Adult,White Collar,0.03439862200520179,False,3,4,10,17
72,39,Young Adult,White Collar,0.15937752033309405,False,2,4,14,20
73,40,Young Adult,Student,0.2615158445906097,False,1,4,14,19
74,22,Young Adult,Blue Collar,0.2491194021961276,False,2,3,12,17
75,25,Young Adult,Blue Collar,0.0685869246308145,False,5,4,18,27
76,49,Middle Age,White Collar,0.45950640724990544,False,3,5,10,18
77,69,Elderly,Student,0.5414781386117564,False,5,3,10,18
78,19,Young Adult,White Collar,0.26059606181093153,False,3,5,19,27
79,76,Elderly,Blue Collar,0.06753590748378506,False,3,4,15,22
80,19,Young Adult,Student,0.04676883497272682,False,3,4,18,25
81,45,Middle Age,White Collar,0.12713147658095109,False,3,3,18,24
82,23,Young Adult,White Collar,0.3265987258278122,True,1,4,16,21
83,20,Young Adult,Blue Collar,0.11912486541113898,False,3,3,14,20
84,22,Young Adult,White Collar,0.10776704550146234,False,3,4,15,22
85,60,Middle Age,Blue Collar,0.32460102630740867,False,3,4,13,20
86,24,Young Adult,Retired,0.21935449118475614,False,3,3,19,25
87,41,Middle Age,Student,0.30479223202169464,False,1,3,18,22
88,54,Middle Age,Blue Collar,0.403730071467841,False,2,4,16,22
89,49,Middle Age,Student,0.18412892169781056,False,5,3,11,19
90,20,Young Adult,Blue Collar,0.23447365948588197,False,3,4,12,19
91,55,Middle Age,White Collar,0.175068748991844,False,3,4,18,25
92,48,Middle Age,Student,0.2673316734797696,False,2,4,20,26
93,21,Young Adult,Retired,0.238699744225137,False,3,5,16,24
94,53,Middle Age,Blue Collar,0.32579561073076047,False,4,4,8,16
95,19,Young Adult,Student,0.4434878606676832,False,5,4,14,23
96,8,Youth,Student,0.3855671372233749,False,3,5,16,24
97,29,Young Adult,White Collar,0.09615258168656671,False,3,4,8,15
98,18,Youth,Student,0.2089847738799713,True,2,4,15,21
99,35,Young Adult,Retired,0.16619623428044838,False,4,4,15,23
100,64,Middle Age,Blue Collar,0.22721487350505115,False,2,4,11,17
101,40,Young Adult,Retired,0.47592049646427265,False,3,4,16,23
102,44,Middle Age,Blue Collar,0.11588479103164939,False,2,4,12,18
103,32,Young Adult,White Collar,0.1718540724955221,False,3,4,16,23
104,25,Young Adult,White Collar,0.24093580883068486,False,3,4,12,19
105,46,Middle Age,Blue Collar,0.19658545353951162,False,3,4,21,28
106,19,Young Adult,White Collar,0.15450740124203077,False,3,4,16,23
107,60,Middle Age,Blue Collar,0.3024753876496196,False,1,4,16,21
108,25,Young Adult,White Collar,0.2628503990216566,False,1,5,17,23
109,76,Elderly,Blue Collar,0.17838548982713634,False,2,4,15,21
110,60,Middle Age,White Collar,0.07140336869412171,False,0,3,18,21
111,62,Middle Age,White Collar,0.36804793518398216,False,2,4,14,20
112,1,Youth,Student,0.16500239921085022,False,3,4,15,22
113,43,Middle Age,White Collar,0.6463769483914986,False,3,5,13,21
114,31,Young Adult,White Collar,0.5031230845032987,False,3,4,17,24
115,41,Middle Age,Blue Collar,0.40864698504559716,False,3,3,15,21
116,65,Middle Age,White Collar,0.3784719386186747,False,1,5,15,21
117,99,Elderly,White Collar,0.4808171104256128,False,2,5,11,18
118,73,Elderly,White Collar,0.45015277145501226,False,3,4,14,21
119,58,Middle Age,White Collar,0.31485465592718676,False,2,4,13,19
120,60,Middle Age,Blue Collar,0.3458306244455384,False,5,4,15,24
121,36,Young Adult,White Collar,0.5386521682270735,False,2,4,13,19
122,55,Middle Age,White Collar,0.30617217969438143,False,3,3,22,28
123,65,Middle Age,Blue Collar,0.14558813424442504,False,1,4,16,21
124,33,Young Adult,Student,0.4518857472364912,False,4,4,13,21
125,29,Young Adult,Blue Collar,0.35993742481792457,True,2,4,16,22
126,12,Youth,Blue Collar,0.06190643377169209,False,3,4,14,21
127,13,Youth,White Collar,0.2328545928203029,False,5,3,13,21
128,13,Youth,White Collar,0.19208246644942936,False,4,4,20,28
129,67,Elderly,Blue Collar,0.5199092769591175,False,4,3,18,25
130,19,Young Adult,Retired,0.22019437403991562,False,3,4,19,26
131,32,Young Adult,White Collar,0.13772023575141254,False,4,4,17,25
132,48,Middle Age,White Collar,0.47197128618272305,False,2,5,16,23
133,31,Young Adult,White Collar,0.1588460545173127,False,5,3,11,19
134,24,Young Adult,Blue Collar,0.059689475270839516,False,5,4,12,21
135,100,Elderly,Student,0.34081565965226834,False,4,5,20,29
136,19,Young Adult,Student,0.30664861826340883,False,5,4,14,23
137,46,Middle Age,Student,0.2789555071166884,False,3,4,14,21
138,29,Young Adult,White Collar,0.3288097857207583,False,3,4,15,22
139,32,Young Adult,White Collar,0.40649018963913885,True,2,3,8,13
140,17,Youth,Student,0.32345967824352123,False,1,2,14,17
141,21,Young Adult,Blue Collar,0.18134288505174043,False,5,4,15,24
142,48,Middle Age,Student,0.11034442080402906,True,3,4,17,24
143,4,Youth,White Collar,0.06261134174457317,False,3,4,16,23
144,95,Elderly,Blue Collar,0.3893738659278771,False,3,4,16,23
145,3,Youth,Blue Collar,0.22081199239815466,False,3,3,15,21
146,37,Young Adult,Student,0.17057746068742893,False,4,4,18,26
147,53,Middle Age,White Collar,0.06763603384706811,False,3,5,17,25
148,7,Youth,Student,0.20636937130196562,False,3,4,19,26
149,60,Middle Age,Blue Collar,0.35879012288277545,False,4,3,17,24
150,20,Young Adult,White Collar,0.316899984774653,False,5,4,12,21
151,35,Young Adult,Blue Collar,0.1365637082251592,True,3,3,20,26
152,34,Young Adult,Student,0.21708374305025172,False,4,5,18,27
153,55,Middle Age,Blue Collar,0.1363792431986001,False,1,4,20,25
154,61,Middle Age,White Collar,0.06373493040686784,False,3,3,17,23
155,34,Young Adult,White Collar,0.5785716282335199,False,1,4,15,20
156,29,Young Adult,Blue Collar,0.16737543318713216,False,5,4,15,24
157,14,Youth,Student,0.485750585203021,False,3,4,15,22
158,53,Middle Age,White Collar,0.2231288814404552,False,2,3,19,24
159,34,Young Adult,Student,0.37344884728495387,False,3,3,10,16
160,38,Young Adult,Blue Collar,0.38660756941930585,False,3,4,18,25
161,6,Youth,Student,0.29103929254547434,False,4,4,14,22
162,26,Young Adult,Blue Collar,0.3584957567261279,False,3,4,17,24
163,19,Young Adult,Student,0.36884852544610003,False,5,4,17,26
164,50,Middle Age,Blue Collar,0.43385584819172346,False,3,4,10,17
165,30,Young Adult,White Collar,0.05932432661715326,False,0,6,18,24
166,33,Young Adult,White Collar,0.15373830274583952,False,4,4,13,21
167,6,Youth,White Collar,0.690927168796683,False,3,2,19,24
168,77,Elderly,Student,0.04927096831835294,False,5,4,15,24
169,37,Young Adult,Retired,0.18591584017139418,False,2,4,10,16
170,22,Young Adult,Blue Collar,0.2715695031402613,False,5,4,11,20
171,28,Young Adult,Student,0.3219105263709601,False,1,5,15,21
172,20,Young Adult,White Collar,0.48209428949031524,False,5,4,14,23
173,15,Youth,Student,0.319706275524256,True,4,4,17,25
174,34,Young Adult,White Collar,0.4916099383257625,False,4,4,19,27
175,15,Youth,Student,0.18417297086710416,True,3,4,22,29
176,37,Young Adult,Blue Collar,0.029392249773945323,True,3,3,16,22
177,18,Youth,Retired,0.43832440071116074,True,3,5,16,24
178,36,Young Adult,Blue Collar,0.22019917819165558,False,4,4,16,24
179,48,Middle Age,Blue Collar,0.1272898020531447,False,3,3,11,17
180,85,Elderly,Blue Collar,0.5623099425360222,False,5,3,12,20
181,38,Young Adult,Student,0.1351692568264888,False,2,4,13,19
182,6,Youth,Blue Collar,0.18926525270317185,False,5,4,24,33
183,7,Youth,Student,0.2788522124309327,True,5,4,17,26
184,14,Youth,Blue Collar,0.2584988688589334,False,5,4,20,29
185,9,Youth,Blue Collar,0.1713624183536284,False,2,5,13,20
186,40,Young Adult,Student,0.3902904125361203,False,2,3,18,23
187,59,Middle Age,Blue Collar,0.13884092876465817,False,4,4,9,17
188,36,Young Adult,Student,0.4659217194194351,False,3,3,14,20
189,23,Young Adult,Student,0.6157519764816631,False,3,4,16,23
190,37,Young Adult,Retired,0.3073799210471541,False,3,4,13,20
191,28,Young Adult,Blue Collar,0.3116610941567272,False,4,4,11,19
192,34,Young Adult,White Collar,0.1347012643177103,False,2,5,16,23
193,64,Middle Age,White Collar,0.7239031844967967,False,2,4,11,17
194,18,Youth,White Collar,0.11910027770778647,True,1,4,18,23
195,49,Middle Age,White Collar,0.28538578892011157,False,3,5,19,27
196,16,Youth,Blue Collar,0.514309690041867,False,3,4,10,17
197,18,Youth,White Collar,0.15648979507517,False,5,4,15,24
198,96,Elderly,White Collar,0.26055752603134724,False,2,4,14,20
199,46,Middle Age,White Collar,0.13981359053542353,False,3,4,11,18
200,31,Young Adult,Blue Collar,0.388093991336372,False,1,4,16,21
201,29,Young Adult,White Collar,0.4641645770320866,False,3,4,17,24
202,57,Middle Age,Blue Collar,0.12845804774166797,True,2,4,16,22
203,55,Middle Age,White Collar,0.0552063959733059,False,5,4,24,33
204,34,Young Adult,Blue Collar,0.017279127080126834,False,5,3,16,24
205,36,Young Adult,Student,0.15924986868506363,False,3,4,16,23
206,56,Middle Age,Student,0.2667449952728772,False,4,3,21,28
207,48,Middle Age,Blue Collar,0.529692033598347,False,4,4,13,21
208,13,Youth,Student,0.3071017670062408,False,5,3,16,24
209,95,Elderly,Retired,0.2504805636294226,False,3,3,16,22
210,9,Youth,White Collar,0.40355832138751585,False,1,4,10,15
211,56,Middle Age,Student,0.3696214928596068,False,3,4,13,20
212,38,Young Adult,White Collar,0.22078097776764183,False,4,4,16,24
213,49,Middle Age,Blue Collar,0.09074148599417395,False,2,4,13,19
214,35,Young Adult,White Collar,0.42629856137072764,True,5,4,20,29
215,59,Middle Age,White Collar,0.3076570372812911,False,4,4,13,21
216,55,Middle Age,White Collar,0.08686886954251043,False,4,3,14,21
217,36,Young Adult,White Collar,0.31988267906477214,False,4,4,16,24
218,63,Middle Age,Student,0.17245945458117015,False,1,3,15,19
219,54,Middle Age,Student,0.5236077465948994,False,5,4,14,23
220,53,Middle Age,White Collar,0.14411306049989406,False,3,5,17,25
221,45,Middle Age,White Collar,0.4369016405600799,True,5,5,13,23
222,37,Young Adult,White Collar,0.5620366156958401,False,3,4,12,19
223,44,Middle Age,White Collar,0.20388080864478686,False,3,4,12,19
224,54,Middle Age,Blue Collar,0.26526006970231497,False,2,4,11,17
225,8,Youth,White Collar,0.342996453032718,False,2,4,14,20
226,51,Middle Age,Blue Collar,0.3081745146780117,False,2,4,13,19
227,29,Young Adult,Blue Collar,0.07847640863395768,False,4,4,16,24
228,36,Young Adult,Student,0.20417842853949858,True,1,4,21,26
229,50,Middle Age,Retired,0.46757480171249854,False,3,4,17,24
230,22,Young Adult,Blue Collar,0.22444388214291414,False,0,4,15,19
231,5,Youth,Blue Collar,0.5642742600782021,False,4,3,18,25
232,1,Youth,White Collar,0.45836380319932735,False,0,5,21,26
233,16,Youth,White Collar,0.22873235215695734,False,3,3,16,22
234,5,Youth,Student,0.19416253232713945,False,3,4,8,15
235,48,Middle Age,White Collar,0.11404878475035836,False,2,5,16,23
236,39,Young Adult,White Collar,0.11886389807223895,False,4,3,13,20
237,14,Youth,Retired,0.22430032560849703,False,2,3,13,18
238,14,Youth,Retired,0.1748455929095408,False,3,4,15,22
239,32,Young Adult,Blue Collar,0.23810184430754955,False,4,5,13,22
240,31,Young Adult,Blue Collar,0.43794334939116214,False,2,4,19,25
241,30,Young Adult,White Collar,0.3050820962749862,False,1,4,12,17
242,40,Young Adult,White Collar,0.4110151238583872,True,3,5,14,22
243,65,Middle Age,Blue Collar,0.23841138620236768,True,5,3,16,24
244,56,Middle Age,Blue Collar,0.30555856203807996,False,4,4,13,21
245,48,Middle Age,Blue Collar,0.22431198667381724,False,3,4,9,16
246,60,Middle Age,White Collar,0.22830350418430012,False,3,5,16,24
247,62,Middle Age,Blue Collar,0.601389322500987,False,4,4,13,21
248,68,Elderly,White Collar,0.1861016376343618,False,4,3,16,23
249,23,Young Adult,Student,0.33223765339141825,False,3,5,9,17
250,46,Middle Age,Student,0.1535906531023021,False,3,3,19,25
251,52,Middle Age,White Collar,0.5895945688191788,False,1,5,15,21
252,49,Middle Age,Retired,0.13601113584966545,False,5,4,13,22
253,84,Elderly,Blue Collar,0.1452923245069306,False,3,6,10,19
254,2,Youth,Student,0.4696325075583425,False,3,4,12,19
255,64,Middle Age,Blue Collar,0.34705488787399064,False,3,3,11,17
256,58,Middle Age,White Collar,0.2243778179558153,False,3,4,12,19
257,17,Youth,Student,0.380680807328598,False,2,4,15,21
258,49,Middle Age,White Collar,0.25273846971971753,False,2,4,19,25
259,72,Elderly,Blue Collar,0.19184179202086682,False,4,4,15,23
260,58,Middle Age,White Collar,0.21777087913042306,False,2,4,16,22
261,61,Middle Age,Blue Collar,0.5469541833338392,False,4,4,15,23
262,32,Young Adult,Student,0.43202781936331336,True,3,3,14,20
263,15,Youth,Student,0.337528941637207,False,1,4,13,18
264,31,Young Adult,White Collar,0.2801225539599779,False,4,4,14,22
265,58,Middle Age,White Collar,0.20469271636460634,False,3,4,14,21
266,13,Youth,Blue Collar,0.19782889115756616,False,3,4,15,22
267,49,Middle Age,Student,0.42009875160522375,False,4,3,11,18
268,26,Young Adult,Blue Collar,0.0945684310647346,True,3,4,18,25
269,58,Middle Age,Retired,0.0683369109310005,False,3,5,16,24
270,8,Youth,Student,0.37337115119161546,False,4,4,16,24
271,55,Middle Age,Student,0.18149745939782988,False,3,4,16,23
272,41,Middle Age,Student,0.4688203508208859,False,3,3,12,18
273,79,Elderly,Student,0.4418376196321603,False,5,3,19,27
274,25,Young Adult,Blue Collar,0.27311956524215825,False,4,4,13,21
275,60,Middle Age,Student,0.4417392325829916,False,0,4,13,17
276,4,Youth,White Collar,0.45149946593464635,False,3,4,22,29
277,0,Youth,Student,0.5143025110676812,False,2,4,16,22
278,59,Middle Age,White Collar,0.19848042283768558,False,3,4,17,24
279,13,Youth,White Collar,0.05624495924290872,False,2,4,7,13
280,30,Young Adult,White Collar,0.013096916111202185,False,3,5,16,24
281,38,Young Adult,Student,0.4422153449338335,False,2,3,18,23
282,57,Middle Age,White Collar,0.2563288233480382,False,4,4,17,25
283,15,Youth,Blue Collar,0.12008037150759632,False,3,4,14,21
284,14,Youth,Student,0.2906548683413762,True,3,4,17,24
285,43,Middle Age,Student,0.248426499061781,False,4,4,15,23
286,29,Young Adult,White Collar,0.27311496256388507,False,1,5,17,23
287,35,Young Adult,Blue Collar,0.23103274537339663,True,0,4,16,20
288,61,Middle Age,Blue Collar,0.3977583849607771,False,2,4,13,19
289,47,Middle Age,White Collar,0.12280995074610727,False,3,3,19,25
290,33,Young Adult,White Collar,0.24431246570620366,False,4,4,18,26
291,29,Young Adult,Blue Collar,0.16905503117317644,False,2,4,15,21
292,15,Youth,Student,0.3630143517577401,False,3,4,18,25
293,3,Youth,Blue Collar,0.15939157930324252,False,5,4,14,23
294,1,Youth,White Collar,0.09801246109614241,False,4,4,12,20
295,22,Young Adult,White Collar,0.32587444392919906,False,5,3,12,20
296,93,Elderly,Blue Collar,0.3065108052415546,False,1,3,17,21
297,85,Elderly,White Collar,0.07671218365016587,False,3,4,15,22
298,40,Young Adult,White Collar,0.4728620841435421,False,1,3,19,23
299,36,Young Adult,White Collar,0.31570110112731165,False,1,4,15,20
300,32,Young Adult,Blue Collar,0.20630964194203893,False,3,4,12,19
301,60,Middle Age,Blue Collar,0.03867293865424374,False,3,5,11,19
302,62,Middle Age,Blue Collar,0.4168670056078366,False,3,4,16,23
303,9,Youth,Retired,0.30526408172006453,False,3,4,15,22
304,4,Youth,White Collar,0.360409463644948,False,3,4,18,25
305,0,Youth,Student,0.31965237212640535,False,3,4,14,21
306,33,Young Adult,White Collar,0.06039203154803854,False,4,4,17,25
307,65,Middle Age,Retired,0.21767561927151582,False,3,4,11,18
308,45,Middle Age,Student,0.4233910425225104,False,2,4,19,25
309,49,Middle Age,White Collar,0.08575359616064851,False,4,4,17,25
310,54,Middle Age,White Collar,0.24114210026316804,False,1,4,16,21
311,13,Youth,Student,0.10682136950093098,False,3,5,14,22
312,35,Young Adult,Blue Collar,0.39399743206671656,True,3,4,19,26
313,38,Young Adult,Student,0.25572263337086576,False,4,4,14,22
314,74,Elderly,Blue Collar,0.3840811292272226,False,3,4,12,19
315,15,Youth,Blue Collar,0.36614580595245383,False,5,4,19,28
316,26,Young Adult,White Collar,0.5816434885743039,False,3,4,22,29
317,43,Middle Age,White Collar,0.5621775612709531,False,3,4,19,26
318,33,Young Adult,Retired,0.08844444030069641,False,4,4,18,26
319,37,Young Adult,White Collar,0.3446235300029249,False,5,4,11,20
320,31,Young Adult,Student,0.6095654722173228,False,5,3,13,21
321,60,Middle Age,White Collar,0.3141309765261968,False,3,4,10,17
322,32,Young Adult,Blue Collar,0.6479463612947148,False,5,4,17,26
323,35,Young Adult,Student,0.22650191954925245,False,4,4,10,18
324,48,Middle Age,White Collar,0.4532267059451018,False,3,4,25,32
325,22,Young Adult,White Collar,0.5996218506997747,False,3,4,16,23
326,52,Middle Age,Blue Collar,0.13623186235398355,False,2,4,17,23
327,48,Middle Age,Student,0.2361379497655822,False,3,5,15,23
328,4,Youth,Blue Collar,0.6046614565204121,False,5,4,13,22
329,15,Youth,White Collar,0.2920487185984639,False,3,4,12,19
330,40,Young Adult,Retired,0.4004222737895427,False,5,4,13,22
331,60,Middle Age,White Collar,0.45077109441955576,False,4,3,22,29
332,33,Young Adult,Student,0.18480186641013244,False,2,5,13,20
333,27,Young Adult,White Collar,0.41019293380539773,False,3,4,15,22
334,14,Youth,White Collar,0.34973434990572005,True,4,5,16,25
335,43,Middle Age,Blue Collar,0.17561919698936396,False,4,4,15,23
336,16,Youth,White Collar,0.2052622268743936,False,4,4,14,22
337,68,Elderly,White Collar,0.6085560017364287,False,5,4,15,24
338,51,Middle Age,Blue Collar,0.14165877053537307,False,4,4,13,21
339,94,Elderly,Student,0.43593946275941003,False,1,4,16,21
340,21,Young Adult,White Collar,0.3082365330185971,False,2,4,15,21
341,33,Young Adult,Retired,0.45500639880107346,False,2,4,11,17
342,52,Middle Age,White Collar,0.42754908476185066,False,5,4,14,23
343,29,Young Adult,Blue Collar,0.2781861683282088,True,1,4,18,23
344,51,Middle Age,Student,0.18524055235766115,True,5,3,19,27
345,50,Middle Age,White Collar,0.5553171992560851,False,3,5,16,24
346,75,Elderly,White Collar,0.5031820579410835,False,5,3,19,27
347,11,Youth,White Collar,0.32184672035858475,False,3,5,15,23
348,45,Middle Age,White Collar,0.2940375021670958,False,4,5,21,30
349,31,Young Adult,Blue Collar,0.12544938510343312,False,3,3,7,13
350,16,Youth,Student,0.44440125056011115,False,5,4,7,16
351,19,Young Adult,White Collar,0.5757688148776429,False,1,3,18,22
352,34,Young Adult,Student,0.12381086556612016,False,4,4,20,28
353,9,Youth,Blue Collar,0.14174247492062755,False,3,5,12,20
354,64,Middle Age,Blue Collar,0.18727519902269188,True,2,5,14,21
355,38,Young Adult,Student,0.19126728643193613,False,4,3,13,20
356,5,Youth,Blue Collar,0.2750086185191396,True,3,6,15,24
357,26,Young Adult,Retired,0.2594732652222252,False,3,3,15,21
358,55,Middle Age,Student,0.11601733753096195,False,3,3,13,19
359,96,Elderly,Retired,0.5878548997680135,False,3,4,19,26
360,59,Middle Age,Retired,0.14184427607987107,False,3,3,20,26
361,31,Young Adult,White Collar,0.26709409153878366,False,1,4,17,22
362,6,Youth,Blue Collar,0.16934940183695033,False,0,3,9,12
363,39,Young Adult,White Collar,0.5051295998717548,False,1,4,14,19
364,99,Elderly,Blue Collar,0.21522630115591282,False,4,4,18,26
365,49,Middle Age,White Collar,0.30267928438841163,False,4,4,12,20
366,43,Middle Age,Retired,0.6043368946581595,False,2,4,14,20
367,30,Young Adult,Retired,0.22644282471136645,False,3,4,15,22
368,30,Young Adult,Student,0.33001023491704745,False,3,3,9,15
369,19,Young Adult,White Collar,0.15526763571837746,True,3,4,20,27
370,51,Middle Age,Blue Collar,0.2640383541633144,False,4,4,18,26
371,34,Young Adult,Blue Collar,0.3870555710169233,False,2,4,11,17
372,55,Middle Age,Blue Collar,0.12195815794277094,False,2,4,21,27
373,6,Youth,Blue Collar,0.23073436812794024,False,5,4,14,23
374,57,Middle Age,White Collar,0.33743284497625053,False,4,4,13,21
375,22,Young Adult,Student,0.07241046297913235,False,2,3,15,20
376,55,Middle Age,Student,0.37822073548513974,False,4,4,18,26
377,36,Young Adult,Student,0.3194343997975769,False,3,4,9,16
378,23,Young Adult,White Collar,0.19725972017809695,True,4,4,8,16
379,37,Young Adult,White Collar,0.28717210051402103,False,2,5,21,28
380,11,Youth,Student,0.6008221918617068,False,2,4,13,19
381,35,Young Adult,White Collar,0.09712260572285623,False,3,6,16,25
382,39,Young Adult,White Collar,0.2750073539162113,False,5,3,18,26
383,52,Middle Age,Blue Collar,0.5045933992123101,False,1,4,9,14
384,61,Middle Age,Student,0.15951835961325392,False,4,4,19,27
385,45,Middle Age,Student,0.21444346597451258,False,3,4,16,23
386,46,Middle Age,Blue Collar,0.46315732764973994,False,3,5,27,35
387,96,Elderly,Blue Collar,0.27810240669822206,False,3,4,13,20
388,14,Youth,Student,0.185040538482732,False,2,4,21,27
389,42,Middle Age,White Collar,0.11455555890742458,False,3,5,18,26
390,36,Young Adult,White Collar,0.4228950555098883,True,3,4,14,21
391,50,Middle Age,White Collar,0.6440679634524121,False,2,4,26,32
392,51,Middle Age,White Collar,0.3083255266751108,False,0,4,20,24
393,31,Young Adult,Blue Collar,0.4105774245043222,False,4,4,16,24
394,24,Young Adult,White Collar,0.19605420588440753,False,4,3,14,21
395,99,Elderly,White Collar,0.13887477350878247,True,3,4,19,26
396,32,Young Adult,Blue Collar,0.09852676123919558,False,2,4,17,23
397,29,Young Adult,Student,0.36726113123900356,False,4,3,17,24
398,33,Young Adult,Blue Collar,0.5073793345737749,False,4,4,16,24
399,52,Middle Age,White Collar,0.2364619685412546,False,5,3,12,20
400,93,Elderly,White Collar,0.4056361401586,False,2,4,18,24
401,70,Elderly,Blue Collar,0.26490977098893786,False,4,3,13,20
402,40,Young Adult,Student,0.3808117943964557,True,3,4,13,20
403,62,Middle Age,Blue Collar,0.22533174704489528,True,2,4,20,26
404,11,Youth,White Collar,0.04515369517060627,False,3,5,19,27
405,4,Youth,Blue Collar,0.16436603283956178,False,3,3,16,22
406,21,Young Adult,White Collar,0.19143069972773935,False,2,2,15,19
407,39,Young Adult,White Collar,0.2616461141449531,False,5,7,18,30
408,5,Youth,White Collar,0.35639372193893865,False,5,3,16,24
409,27,Young Adult,Blue Collar,0.08073936672491931,False,1,3,11,15
410,38,Young Adult,White Collar,0.10845747547886783,False,5,3,12,20
411,22,Young Adult,Student,0.24552664654232526,True,3,4,17,24
412,14,Youth,Retired,0.5453972463065507,False,1,4,19,24
413,86,Elderly,Blue Collar,0.3355411391283527,False,3,4,17,24
414,28,Young Adult,Blue Collar,0.11193257488627385,False,4,5,20,29
415,63,Middle Age,Blue Collar,0.07861861954219991,False,1,4,15,20
416,22,Young Adult,Retired,0.22324955997792298,False,3,3,16,22
417,34,Young Adult,Student,0.23934489305310983,False,4,4,20,28
418,36,Young Adult,Student,0.4691650839986767,False,1,4,8,13
419,12,Youth,Retired,0.10930101287827769,False,2,4,13,19
420,32,Young Adult,Blue Collar,0.350841738423868,True,3,3,9,15
421,70,Elderly,White Collar,0.11473327681688954,False,3,4,10,17
422,36,Young Adult,Blue Collar,0.5209560844968074,False,4,4,19,27
423,93,Elderly,White Collar,0.46291911654104495,False,5,4,14,23
424,57,Middle Age,Student,0.4458084306295856,False,2,5,12,19
425,26,Young Adult,White Collar,0.45074564735850964,False,3,4,15,22
426,43,Middle Age,White Collar,0.207768701685737,False,4,3,16,23
427,23,Young Adult,Blue Collar,0.5530846398930729,False,2,5,12,19
428,5,Youth,White Collar,0.2414057853315312,False,3,4,19,26
429,10,Youth,Blue Collar,0.35219914462398455,False,0,5,15,20
430,41,Middle Age,Student,0.5623335554103934,False,2,5,10,17
431,49,Middle Age,Blue Collar,0.066028107172517,False,3,4,17,24
432,39,Young Adult,Student,0.47801036279397796,False,0,4,12,16
433,39,Young Adult,Retired,0.36195574219105253,False,4,4,22,30
434,62,Middle Age,White Collar,0.4016190764260652,False,3,4,12,19
435,46,Middle Age,White Collar,0.14476908879022118,False,3,5,16,24
436,38,Young Adult,Student,0.14853618339714061,False,2,4,13,19
437,30,Young Adult,Retired,0.2673122822770018,False,3,4,14,21
438,36,Young Adult,Student,0.2665058948831771,False,5,4,19,28
439,14,Youth,Student,0.2016844401116823,True,3,4,15,22
440,31,Young Adult,Blue Collar,0.5191348577625704,False,3,4,8,15
441,76,Elderly,Blue Collar,0.012576968831467986,False,3,4,16,23
442,47,Middle Age,Blue Collar,0.23005953211192406,False,3,4,18,25
443,34,Young Adult,Blue Collar,0.08916247674529962,False,4,5,18,27
444,12,Youth,White Collar,0.5437183231209585,False,2,4,19,25
445,30,Young Adult,Student,0.3380641675028336,False,3,4,19,26
446,39,Young Adult,Blue Collar,0.22099377678765253,False,1,4,18,23
447,3,Youth,White Collar,0.12232166966906016,False,2,4,14,20
448,65,Middle Age,White Collar,0.32715774615691906,True,1,4,18,23
449,17,Youth,Student,0.09997482682028871,False,3,4,18,25
450,16,Youth,White Collar,0.33759203987394115,False,3,4,13,20
451,60,Middle Age,Blue Collar,0.5828544730774738,False,2,4,19,25
452,91,Elderly,White Collar,0.5490326088038333,False,3,5,13,21
453,30,Young Adult,Blue Collar,0.1444002153105774,False,3,3,16,22
454,35,Young Adult,Student,0.5397886850088234,True,4,4,19,27
455,56,Middle Age,White Collar,0.049103914238015904,False,3,3,14,20
456,45,Middle Age,White Collar,0.2269298672078842,False,3,5,17,25
457,9,Youth,White Collar,0.1507116244682386,False,5,4,12,21
458,34,Young Adult,Blue Collar,0.0397742668078514,False,5,4,17,26
459,52,Middle Age,White Collar,0.41995867755191874,False,5,4,16,25
460,28,Young Adult,Blue Collar,0.4703209324057288,False,3,4,14,21
461,41,Middle Age,White Collar,0.45932256242566094,False,4,4,11,19
462,65,Middle Age,White Collar,0.2928697416440324,False,3,5,16,24
463,15,Youth,Student,0.3253208111970423,False,3,4,17,24
464,53,Middle Age,Student,0.608299740483025,False,5,4,11,20
465,3,Youth,Student,0.227995917813659,False,4,4,9,17
466,32,Young Adult,Blue Collar,0.3285833899501695,False,3,4,16,23
467,56,Middle Age,Blue Collar,0.188908839828141,False,3,5,17,25
468,4,Youth,White Collar,0.4759491652842039,False,5,4,15,24
469,96,Elderly,White Collar,0.46195246754850827,False,3,4,18,25
470,17,Youth,White Collar,0.33552196724204514,False,3,3,20,26
471,64,Middle Age,Blue Collar,0.2913305263540643,False,2,4,14,20
472,34,Young Adult,Student,0.3010360813901332,False,3,4,15,22
473,26,Young Adult,Retired,0.32719066890772697,False,3,4,6,13
474,63,Middle Age,Student,0.06764099286707154,False,1,5,10,16
475,30,Young Adult,White Collar,0.33280396452018296,False,5,5,15,25
476,50,Middle Age,Student,0.5689403837780267,False,3,4,16,23
477,31,Young Adult,Blue Collar,0.16873682327409087,False,1,4,18,23
478,50,Middle Age,Student,0.32347850774297826,False,1,3,16,20
479,14,Youth,Blue Collar,0.25951423642259236,False,3,4,15,22
480,36,Young Adult,White Collar,0.21073410761815942,False,0,4,16,20
481,22,Young Adult,Blue Collar,0.44543893158488235,False,3,5,17,25
482,40,Young Adult,Retired,0.19252517781702655,False,5,5,8,18
483,22,Young Adult,White Collar,0.4215730229751968,False,4,4,18,26
484,4,Youth,Student,0.3147556062634345,False,2,4,12,18
485,92,Elderly,Blue Collar,0.08917514806890406,False,3,4,11,18
486,39,Young Adult,Student,0.18139749745536848,False,2,4,15,21
487,39,Young Adult,Student,0.2888520759798477,False,0,4,16,20
488,48,Middle Age,White Collar,0.19122046404901066,False,2,4,14,20
489,77,Elderly,White Collar,0.25463202598101103,False,3,4,16,23
490,68,Elderly,Retired,0.26260915795931455,False,3,4,18,25
491,28,Young Adult,Blue Collar,0.1868577020761625,True,2,4,13,19
492,22,Young Adult,Retired,0.1235656832485277,False,1,4,19,24
493,39,Young Adult,White Collar,0.3590902667010948,False,3,4,12,19
494,98,Elderly,White Collar,0.007247912732123117,False,5,4,17,26
495,5,Youth,Blue Collar,0.22541229173963975,False,4,4,10,18
496,41,Middle Age,Blue Collar,0.3682584032090778,False,3,3,15,21
497,25,Young Adult,Student,0.47005375734757493,False,3,4,14,21
498,54,Middle Age,White Collar,0.23340795938545686,True,1,4,16,21
499,46,Middle Age,Retired,0.604550623924786,False,2,4,22,28
500,66,Elderly,White Collar,0.11161825582150756,False,3,4,18,25
501,51,Middle Age,White Collar,0.29180063638815756,False,3,4,15,22
502,11,Youth,Blue Collar,0.24367885033200437,True,5,4,11,20
503,9,Youth,Student,0.09117290073823889,False,3,3,16,22
504,85,Elderly,Blue Collar,0.34238261216894417,False,3,3,20,26
505,89,Elderly,Blue Collar,0.2613583638874165,False,4,5,13,22
506,4,Youth,White Collar,0.10545421749979744,False,3,5,18,26
507,36,Young Adult,Retired,0.33941958951777684,False,3,4,15,22
508,47,Middle Age,Blue Collar,0.06674404650508572,False,3,4,11,18
509,21,Young Adult,White Collar,0.39484478584956023,False,3,4,13,20
510,37,Young Adult,Student,0.17015973446901886,False,5,4,15,24
511,78,Elderly,White Collar,0.6912093386389426,False,5,3,18,26
512,35,Young Adult,White Collar,0.17016504307163668,False,5,4,13,22
513,56,Middle Age,Student,0.25965807209419905,False,5,4,13,22
514,55,Middle Age,Student,0.34085924943352575,False,2,4,16,22
515,36,Young Adult,White Collar,0.1936145912070428,False,5,4,13,22
516,53,Middle Age,White Collar,0.4421189571746821,True,1,4,12,17
517,21,Young Adult,Student,0.2918146343826823,False,0,5,14,19
518,1,Youth,Retired,0.0431616328618451,True,3,3,13,19
519,68,Elderly,White Collar,0.08526285170391149,False,5,4,16,25
520,13,Youth,White Collar,0.47376583548934953,False,5,4,20,29
521,31,Young Adult,White Collar,0.2739533039710695,False,3,4,16,23
522,58,Middle Age,Student,0.23739520744884943,False,5,3,19,27
523,17,Youth,White Collar,0.2670788820929144,False,2,4,16,22
524,66,Elderly,Blue Collar,0.1034879707346583,False,3,3,17,23
525,36,Young Adult,White Collar,0.22795113216234186,False,3,4,10,17
526,33,Young Adult,White Collar,0.2627333305254055,False,2,4,18,24
527,73,Elderly,Student,0.6891140409001313,False,3,4,14,21
528,41,Middle Age,Student,0.2505649400674639,True,0,5,10,15
529,33,Young Adult,White Collar,0.24464969297662237,False,3,4,17,24
530,1,Youth,White Collar,0.2767384149382149,False,3,4,12,19
531,20,Young Adult,Student,0.27220512050485735,False,5,4,15,24
532,37,Young Adult,White Collar,0.22994845690931623,False,4,4,12,20
533,51,Middle Age,Student,0.42570532098434083,False,3,4,12,19
534,99,Elderly,Student,0.22271118741639412,False,3,4,17,24
535,18,Youth,Blue Collar,0.4773689304451496,False,1,4,18,23
536,54,Middle Age,White Collar,0.23101298651698982,True,3,4,14,21
537,39,Young Adult,Blue Collar,0.43144353619464987,False,4,6,16,26
538,32,Young Adult,White Collar,0.38687976021019077,False,4,4,13,21
539,17,Youth,White Collar,0.20867813507832503,False,5,4,16,25
540,23,Young Adult,Blue Collar,0.09002499819996725,False,3,5,15,23
541,32,Young Adult,White Collar,0.6038569167009646,False,3,3,14,20
542,25,Young Adult,White Collar,0.22652332523012098,True,3,4,13,20
543,30,Young Adult,Student,0.3042970610133372,False,3,2,16,21
544,8,Youth,White Collar,0.16462586137498683,False,5,5,13,23
545,2,Youth,Student,0.1823972362349482,False,2,3,11,16
546,58,Middle Age,Student,0.4766491048877699,False,2,3,16,21
547,85,Elderly,Retired,0.5264086385938195,True,2,4,15,21
548,73,Elderly,Blue Collar,0.36092031234155697,False,5,5,10,20
549,79,Elderly,White Collar,0.2509553296201303,False,2,4,14,20
550,28,Young Adult,White Collar,0.3835316726535463,False,0,4,14,18
551,27,Young Adult,White Collar,0.19591171866205373,False,3,4,16,23
552,34,Young Adult,Blue Collar,0.2976150813463317,False,3,4,16,23
553,29,Young Adult,White Collar,0.13237350274514814,False,3,4,13,20
554,23,Young Adult,Student,0.12631168044090502,False,3,3,17,23
555,32,Young Adult,White Collar,0.35476652265808534,False,3,4,17,24
556,37,Young Adult,Blue Collar,0.3219807096428471,False,3,4,9,16
557,62,Middle Age,White Collar,0.310809260614259,False,4,4,15,23
558,39,Young Adult,Blue Collar,0.22661352635262422,False,1,4,15,20
559,52,Middle Age,Student,0.3116613226660596,False,3,4,12,19
560,36,Young Adult,Retired,0.17217359051439798,False,1,4,13,18
561,21,Young Adult,Retired,0.041466975212824844,False,3,4,15,22
562,54,Middle Age,Student,0.2761974130074415,False,3,4,13,20
563,4,Youth,Student,0.09425356031693806,False,3,4,8,15
564,38,Young Adult,Blue Collar,0.4118445340829866,False,2,5,12,19
565,97,Elderly,Student,0.5157009792685964,False,3,4,12,19
566,19,Young Adult,White Collar,0.6342283268293691,False,3,4,10,17
567,67,Elderly,White Collar,0.27170217319000567,False,3,4,14,21
568,24,Young Adult,Student,0.16115555595365097,True,3,4,15,22
569,6,Youth,Blue Collar,0.3019616530585536,False,4,4,13,21
570,31,Young Adult,Student,0.24747616586330073,False,5,6,15,26
571,26,Young Adult,Retired,0.2773672197869529,False,2,3,13,18
572,43,Middle Age,Blue Collar,0.47222499596045936,False,3,4,17,24
573,43,Middle Age,White Collar,0.21903951367592533,False,2,3,13,18
574,39,Young Adult,Student,0.25130404126245265,False,4,4,10,18
575,32,Young Adult,Blue Collar,0.13449891422559376,False,4,4,7,15
576,72,Elderly,Blue Collar,0.2575375190463321,False,4,3,16,23
577,37,Young Adult,White Collar,0.5758311543371692,True,4,4,17,25
578,8,Youth,Blue Collar,0.17478898807467766,False,3,4,14,21
579,10,Youth,Student,0.4404393990716352,False,5,3,13,21
580,12,Youth,Retired,0.23996872315505707,False,3,4,13,20
581,37,Young Adult,Blue Collar,0.4457504855829945,False,5,4,12,21
582,51,Middle Age,White Collar,0.41814573239418396,False,4,4,16,24
583,63,Middle Age,Blue Collar,0.12477872464880943,False,4,4,14,22
584,69,Elderly,Student,0.4135696874278296,False,3,4,12,19
585,12,Youth,Retired,0.08552216071945434,False,3,4,13,20
586,55,Middle Age,White Collar,0.10238495285184403,False,3,3,13,19
587,93,Elderly,Student,0.22850508874050057,False,3,4,10,17
588,38,Young Adult,White Collar,0.5466614162505907,False,3,3,15,21
589,8,Youth,Student,0.35108503224370974,False,3,4,14,21
590,64,Middle Age,White Collar,0.13941057604626686,False,4,4,21,29
591,9,Youth,White Collar,0.05369951548994858,False,4,4,14,22
592,2,Youth,Student,0.3806987361056626,False,4,5,14,23
593,32,Young Adult,Student,0.2794224044294483,True,3,4,10,17
594,38,Young Adult,White Collar,0.3066911814390244,False,1,4,24,29
595,28,Young Adult,White Collar,0.34303308364673246,False,5,3,15,23
596,58,Middle Age,Retired,0.47611454437072104,False,2,5,13,20
597,24,Young Adult,Blue Collar,0.2554704259647891,False,3,4,13,20
598,27,Young Adult,White Collar,0.5012006017832084,True,5,4,14,23
599,32,Young Adult,White Collar,0.15400666296079904,False,3,5,8,16
600,26,Young Adult,Blue Collar,0.06323234040516468,False,4,3,17,24
601,55,Middle Age,Student,0.44834545888275384,False,3,4,18,25
602,87,Elderly,Blue Collar,0.10997586339778063,False,3,4,16,23
603,55,Middle Age,White Collar,0.29980310270744265,False,1,5,12,18
604,60,Middle Age,Student,0.5363077304756033,False,4,4,16,24
605,78,Elderly,White Collar,0.06705426999363957,False,4,3,14,21
606,29,Young Adult,White Collar,0.3373425781481131,False,3,3,23,29
607,37,Young Adult,Blue Collar,0.06163751556213369,False,5,4,16,25
608,31,Young Adult,White Collar,0.2669105924136806,False,3,4,22,29
609,17,Youth,Student,0.014681933127792124,False,0,4,12,16
610,14,Youth,Retired,0.09291290127017372,False,2,5,11,18
611,63,Middle Age,Student,0.16208459011388984,False,2,5,16,23
612,62,Middle Age,White Collar,0.05558771864927384,False,3,4,16,23
613,40,Young Adult,Student,0.3628731421368042,False,4,5,13,22
614,33,Young Adult,Retired,0.32618555306964203,False,2,4,13,19
615,35,Young Adult,Retired,0.5516768599767246,False,4,5,10,19
616,20,Young Adult,Blue Collar,0.10991865606237472,False,4,3,18,25
617,58,Middle Age,White Collar,0.21718481039517945,False,0,4,16,20
618,7,Youth,Blue Collar,0.07822097883115157,False,3,4,16,23
619,42,Middle Age,White Collar,0.1767688055025618,False,5,4,11,20
620,65,Middle Age,White Collar,0.5954379734962468,False,2,5,15,22
621,3,Youth,White Collar,0.39717268660938093,False,2,4,15,21
622,37,Young Adult,Blue Collar,0.1055672064555032,False,3,4,11,18
623,33,Young Adult,Blue Collar,0.031185910555505757,False,5,4,11,20
624,30,Young Adult,Retired,0.027957961979081927,False,3,4,20,27
625,21,Young Adult,Student,0.36797659433535934,False,3,4,15,22
626,9,Youth,White Collar,0.159129571300425,False,2,4,15,21
627,30,Young Adult,White Collar,0.7380869638355531,False,3,4,16,23
628,51,Middle Age,Student,0.24369917696780016,True,4,4,13,21
629,41,Middle Age,Blue Collar,0.17097774059130702,False,3,4,15,22
630,46,Middle Age,Retired,0.08072398199878913,False,3,4,22,29
631,36,Young Adult,Student,0.4477791997522805,False,2,4,17,23
632,80,Elderly,Blue Collar,0.19735165471552502,False,4,4,12,20
633,13,Youth,White Collar,0.26147296955370153,False,4,3,18,25
634,55,Middle Age,White Collar,0.2791904822094437,False,0,4,19,23
635,47,Middle Age,White Collar,0.24924642287697085,False,3,4,12,19
636,59,Middle Age,Student,0.38880045320267814,False,3,3,12,18
637,10,Youth,Student,0.08983097773481848,False,1,3,16,20
638,56,Middle Age,White Collar,0.2393537041475697,False,5,4,14,23
639,38,Young Adult,White Collar,0.20045204994057464,False,3,5,13,21
640,33,Young Adult,Blue Collar,0.40099694375353145,False,2,3,14,19
641,50,Middle Age,Retired,0.4674355152035755,False,2,4,12,18
642,51,Middle Age,Student,0.12791579245418194,False,3,3,9,15
643,4,Youth,White Collar,0.40373494198452503,False,2,4,12,18
644,12,Youth,White Collar,0.08948655761560051,False,4,4,15,23
645,39,Young Adult,Retired,0.24781566399063273,False,4,4,10,18
646,9,Youth,Student,0.26449203451846,False,5,5,15,25
647,20,Young Adult,Blue Collar,0.4549932251283338,False,4,5,14,23
648,25,Young Adult,Blue Collar,0.38950793387251037,False,3,5,22,30
649,34,Young Adult,White Collar,0.09718177285658083,False,3,4,18,25
650,55,Middle Age,White Collar,0.3828986050331805,True,3,5,13,21
651,7,Youth,White Collar,0.297838427885603,False,4,4,17,25
652,24,Young Adult,Blue Collar,0.5903979088514874,False,5,5,16,26
653,56,Middle Age,White Collar,0.17609833187507087,False,5,4,14,23
654,17,Youth,Blue Collar,0.2144134952920709,False,4,4,19,27
655,42,Middle Age,Blue Collar,0.6204682337798468,False,4,3,18,25
656,32,Young Adult,Student,0.48723314496000425,False,1,4,20,25
657,50,Middle Age,Blue Collar,0.09620692451496077,True,5,4,16,25
658,21,Young Adult,White Collar,0.24965580347196684,False,2,4,23,29
659,48,Middle Age,Student,0.34123779909224605,False,3,4,13,20
660,63,Middle Age,Blue Collar,0.4009150563139554,False,3,4,17,24
661,47,Middle Age,Blue Collar,0.11793590761943248,False,4,4,13,21
662,36,Young Adult,White Collar,0.5572754113921149,False,3,4,15,22
663,28,Young Adult,White Collar,0.06294278801876782,False,5,5,12,22
664,62,Middle Age,Blue Collar,0.12295220654768162,False,4,4,18,26
665,54,Middle Age,Retired,0.5302969759506505,False,3,4,15,22
666,45,Middle Age,Blue Collar,0.2709993961105075,False,1,4,12,17
667,10,Youth,Blue Collar,0.27708902751884185,False,2,4,16,22
668,56,Middle Age,Student,0.301184192228817,False,0,4,14,18
669,53,Middle Age,White Collar,0.14014940155761468,False,4,4,18,26
670,43,Middle Age,White Collar,0.07373378490111673,False,4,4,12,20
671,52,Middle Age,White Collar,0.32915651051709327,False,4,4,16,24
672,21,Young Adult,Blue Collar,0.359768584824016,False,5,4,16,25
673,52,Middle Age,Blue Collar,0.30977747327024047,False,2,4,14,20
674,32,Young Adult,Blue Collar,0.18035041428788406,False,3,4,14,21
675,28,Young Adult,White Collar,0.11049325801614986,False,4,3,11,18
676,34,Young Adult,Blue Collar,0.2268526189451653,False,3,5,14,22
677,42,Middle Age,Student,0.6389059701703222,False,3,5,9,17
678,22,Young Adult,Retired,0.24313915351568324,False,4,6,15,25
679,32,Young Adult,Student,0.21596804604807857,False,4,5,17,26
680,9,Youth,Student,0.24855717435847977,False,1,4,14,19
681,39,Young Adult,White Collar,0.23747045971287373,True,3,3,14,20
682,61,Middle Age,Student,0.5319284493276698,False,2,4,10,16
683,26,Young Adult,White Collar,0.39043892434622446,True,2,5,10,17
684,6,Youth,White Collar,0.16973758904288572,False,0,4,17,21
685,40,Young Adult,White Collar,0.204026175015018,True,4,3,18,25
686,22,Young Adult,Retired,0.25492632671059895,False,4,4,18,26
687,2,Youth,Student,0.28906082696293733,True,2,4,16,22
688,44,Middle Age,White Collar,0.14078969013769074,False,3,4,17,24
689,4,Youth,Blue Collar,0.18846863488275697,False,2,4,14,20
690,18,Youth,Student,0.5651992012277928,False,3,4,18,25
691,25,Young Adult,Blue Collar,0.5441384134079766,False,4,4,16,24
692,40,Young Adult,White Collar,0.20749581324893812,False,3,4,13,20
693,45,Middle Age,Blue Collar,0.1937947313120766,False,5,4,13,22
694,32,Young Adult,White Collar,0.39173659785710696,False,0,4,12,16
695,21,Young Adult,Student,0.0549042835324885,False,3,4,22,29
696,50,Middle Age,Blue Collar,0.513200034727355,False,2,4,11,17
697,62,Middle Age,Blue Collar,0.16801384883050952,False,1,4,14,19
698,47,Middle Age,Blue Collar,0.34984513829632496,False,3,4,11,18
699,7,Youth,White Collar,0.06470899156806993,False,3,4,15,22
700,38,Young Adult,Student,0.3992098512519557,False,2,4,16,22
701,11,Youth,Retired,0.3602074853627584,False,3,6,11,20
702,59,Middle Age,White Collar,0.3368158164406375,False,3,3,16,22
703,15,Youth,Retired,0.12566751557557146,False,2,4,13,19
704,2,Youth,Student,0.18674564305294103,False,3,4,10,17
705,91,Elderly,White Collar,0.3090542956810058,False,3,4,22,29
706,32,Young Adult,White Collar,0.16110471655100672,False,2,4,6,12
707,58,Middle Age,Blue Collar,0.15601939383489905,False,3,4,14,21
708,35,Young Adult,Retired,0.4891720840330514,False,3,4,17,24
709,10,Youth,White Collar,0.0405952160464261,False,5,4,17,26
710,62,Middle Age,Blue Collar,0.5013100171730703,False,5,4,15,24
711,26,Young Adult,Student,0.125480123667906,True,3,4,18,25
712,33,Young Adult,Blue Collar,0.37832624698778555,True,4,4,12,20
713,62,Middle Age,Blue Collar,0.32221290371486117,False,3,4,13,20
714,63,Middle Age,Student,0.12136225357209524,False,3,4,15,22
715,35,Young Adult,Blue Collar,0.16476671994108208,False,3,3,11,17
716,4,Youth,Blue Collar,0.42106902306580285,False,4,4,19,27
717,44,Middle Age,Blue Collar,0.22306564310409913,True,3,3,15,21
718,49,Middle Age,White Collar,0.7475416808203147,False,5,4,17,26
719,70,Elderly,White Collar,0.17653263115212867,False,3,4,16,23
720,18,Youth,Student,0.16939987569774237,False,1,4,11,16
721,59,Middle Age,Blue Collar,0.10123676310915995,False,3,4,10,17
722,41,Middle Age,Student,0.15521976788527783,False,5,3,17,25
723,34,Young Adult,White Collar,0.2516719879928031,False,3,4,16,23
724,1,Youth,White Collar,0.6988438963940432,False,4,4,14,22
725,54,Middle Age,Student,0.16287619472878653,False,3,4,10,17
726,86,Elderly,White Collar,0.03586107451957101,True,3,4,19,26
727,35,Young Adult,Blue Collar,0.18689261626561332,True,3,4,15,22
728,35,Young Adult,Retired,0.28021975907890234,False,4,3,19,26
729,14,Youth,Blue Collar,0.5039853388745347,False,3,4,16,23
730,21,Young Adult,White Collar,0.2905356993774629,True,4,4,17,25
731,37,Young Adult,Blue Collar,0.21370325400439458,False,5,4,16,25
732,30,Young Adult,White Collar,0.17420404077010232,False,5,4,15,24
733,47,Middle Age,Blue Collar,0.39919600736253635,False,3,4,19,26
734,45,Middle Age,Student,0.2659319496638474,False,1,4,9,14
735,30,Young Adult,Blue Collar,0.4020401338219225,False,1,5,20,26
736,10,Youth,Student,0.1054043592980552,False,2,4,18,24
737,64,Middle Age,White Collar,0.18962207868009487,False,4,3,13,20
738,92,Elderly,White Collar,0.3548328182831716,True,3,3,14,20
739,83,Elderly,Student,0.07851743073924757,False,3,5,14,22
740,57,Middle Age,White Collar,0.12350488995470801,False,3,3,18,24
741,21,Young Adult,White Collar,0.24137784545030638,False,2,4,14,20
742,53,Middle Age,Student,0.4688543103047804,False,3,5,11,19
743,23,Young Adult,Student,0.5491671814360513,False,4,5,14,23
744,31,Young Adult,Blue Collar,0.13208665662881736,False,3,4,12,19
745,27,Young Adult,Student,0.29893631402013454,False,5,4,16,25
746,18,Youth,Student,0.5146805029932751,False,5,3,15,23
747,29,Young Adult,White Collar,0.40089713682600786,False,3,4,18,25
748,79,Elderly,White Collar,0.2842255949831302,False,3,4,19,26
749,43,Middle Age,Student,0.31754411011338207,False,5,3,16,24
750,63,Middle Age,Blue Collar,0.13848346987034896,False,2,5,17,24
751,45,Middle Age,Student,0.20097123645401038,False,3,4,21,28
752,35,Young Adult,Student,0.24188964316220724,False,3,4,15,22
753,46,Middle Age,Student,0.2295611941890383,False,5,4,16,25
754,36,Young Adult,Student,0.2156860757163646,False,2,4,17,23
755,45,Middle Age,Student,0.12310958018220286,True,4,4,15,23
756,48,Middle Age,Student,0.5160624858560737,False,3,4,20,27
757,39,Young Adult,Retired,0.2623139249573352,True,3,4,12,19
758,21,Young Adult,Student,0.2309942687514944,True,3,4,9,16
759,94,Elderly,Blue Collar,0.09595128593448145,True,3,4,16,23
760,51,Middle Age,Student,0.340353357371217,False,3,3,15,21
761,18,Youth,White Collar,0.15694670027434335,False,3,4,17,24
762,31,Young Adult,Blue Collar,0.1620025771710848,False,4,4,18,26
763,24,Young Adult,White Collar,0.19459935313145535,False,4,3,24,31
764,7,Youth,Blue Collar,0.3889033363849212,False,1,4,14,19
765,56,Middle Age,Student,0.3240072686151163,False,4,5,21,30
766,6,Youth,Blue Collar,0.05696068686177275,False,3,4,14,21
767,36,Young Adult,Blue Collar,0.5068443274386882,False,1,5,14,20
768,52,Middle Age,White Collar,0.30439250526781686,False,4,4,13,21
769,37,Young Adult,White Collar,0.2972452247392276,False,3,5,17,25
770,10,Youth,White Collar,0.1367056096153261,True,3,4,20,27
771,49,Middle Age,Student,0.44914011712217095,False,4,4,18,26
772,37,Young Adult,Retired,0.25181479605739426,False,2,3,14,19
773,7,Youth,White Collar,0.16951392607312646,False,4,4,9,17
774,69,Elderly,Blue Collar,0.08014649270573643,False,4,4,17,25
775,31,Young Adult,White Collar,0.23253705235538352,False,4,4,17,25
776,46,Middle Age,Student,0.4841625365767797,False,2,4,13,19
777,52,Middle Age,Retired,0.1693257626556566,True,3,4,24,31
778,59,Middle Age,White Collar,0.07477892700140167,False,4,4,13,21
779,15,Youth,White Collar,0.18524232349219433,False,4,4,24,32
780,1,Youth,Student,0.16796351370450527,False,2,5,22,29
781,19,Young Adult,White Collar,0.2763354949660545,False,3,4,9,16
782,51,Middle Age,Blue Collar,0.13097855154707988,False,5,3,10,18
783,51,Middle Age,Student,0.1542500262093677,False,1,4,14,19
784,45,Middle Age,Blue Collar,0.08993538353011882,False,3,4,16,23
785,43,Middle Age,White Collar,0.3465590425511273,False,5,5,13,23
786,22,Young Adult,White Collar,0.16499025374641893,False,5,5,15,25
787,93,Elderly,Blue Collar,0.1454381844637113,False,5,4,12,21
788,46,Middle Age,Blue Collar,0.451163889216197,False,4,4,20,28
789,60,Middle Age,Blue Collar,0.5292063498589319,False,3,4,12,19
790,24,Young Adult,White Collar,0.37717719713879494,False,3,4,18,25
791,24,Young Adult,Blue Collar,0.49771530922633084,False,5,3,13,21
792,91,Elderly,Blue Collar,0.42318456662924475,False,4,4,19,27
793,24,Young Adult,Blue Collar,0.21733647489695554,False,0,4,16,20
794,80,Elderly,Blue Collar,0.10549743468741869,False,4,4,20,28
795,29,Young Adult,Blue Collar,0.17711581607683305,False,3,4,14,21
796,76,Elderly,Blue Collar,0.15601042342477014,False,3,4,12,19
797,62,Middle Age,Blue Collar,0.3583027272484148,False,5,3,17,25
798,27,Young Adult,Student,0.2382117203777517,False,3,4,12,19
799,22,Young Adult,Blue Collar,0.04443763713492062,True,5,4,16,25
800,32,Young Adult,Retired,0.17743415640634938,False,3,3,14,20
801,31,Young Adult,White Collar,0.08105034586883751,False,3,4,14,21
802,59,Middle Age,Blue Collar,0.23325972978998843,False,2,3,15,20
803,2,Youth,Blue Collar,0.4563029734443914,True,3,4,10,17
804,8,Youth,Retired,0.11099512270858747,True,3,4,12,19
805,12,Youth,Student,0.524107383079782,True,2,3,17,22
806,71,Elderly,White Collar,0.2494485341513156,False,4,7,13,24
807,63,Middle Age,Student,0.35765966969172464,False,2,4,17,23
808,13,Youth,Student,0.1411241998676989,False,3,4,15,22
809,25,Young Adult,White Collar,0.25621935561558057,False,3,4,17,24
810,100,Elderly,White Collar,0.5239791499617252,False,4,4,18,26
811,20,Young Adult,White Collar,0.4819498063691885,False,4,4,17,25
812,20,Young Adult,White Collar,0.2639644320402215,False,0,4,17,21
813,40,Young Adult,Blue Collar,0.22351415888456408,False,5,4,13,22
814,6,Youth,Student,0.27642704708167387,False,5,4,19,28
815,3,Youth,White Collar,0.32112925534140707,False,2,3,11,16
816,40,Young Adult,White Collar,0.557406885681536,False,2,4,17,23
817,30,Young Adult,Blue Collar,0.16218908617481992,False,3,4,14,21
818,27,Young Adult,White Collar,0.15480747939205203,False,2,4,14,20
819,59,Middle Age,Student,0.20960392282734935,False,2,4,18,24
820,43,Middle Age,Blue Collar,0.10686653718771086,False,3,4,19,26
821,37,Young Adult,Student,0.36441921405229005,True,4,5,11,20
822,35,Young Adult,White Collar,0.06985421523280302,False,4,4,18,26
823,56,Middle Age,White Collar,0.5752524381494896,False,3,4,13,20
824,31,Young Adult,Retired,0.28165155884564697,False,3,4,12,19
825,35,Young Adult,Blue Collar,0.37944115369394515,False,4,4,17,25
826,44,Middle Age,Retired,0.045659631002925305,False,4,4,16,24
827,76,Elderly,Retired,0.3907392159198113,False,4,4,19,27
828,13,Youth,Student,0.32590294062100394,False,5,4,12,21
829,39,Young Adult,Student,0.3450841502829877,False,3,4,11,18
830,21,Young Adult,Student,0.23701367390107056,False,5,4,14,23
831,27,Young Adult,White Collar,0.4243518655493258,False,5,3,18,26
832,18,Youth,White Collar,0.12881200099088816,False,5,3,15,23
833,23,Young Adult,White Collar,0.3299114686361586,False,3,4,12,19
834,72,Elderly,Retired,0.06675553056618239,False,0,4,14,18
835,9,Youth,Blue Collar,0.10571078303232644,False,3,6,15,24
836,49,Middle Age,White Collar,0.5357995621053333,False,3,4,17,24
837,42,Middle Age,Student,0.15957134377575063,False,2,4,11,17
838,62,Middle Age,Blue Collar,0.12287989871766325,True,2,4,21,27
839,51,Middle Age,Blue Collar,0.30995644773932673,True,1,5,14,20
840,27,Young Adult,Blue Collar,0.5006741240171694,True,3,5,18,26
841,50,Middle Age,White Collar,0.19253338124350866,False,3,5,15,23
842,62,Middle Age,Student,0.6798139772747849,False,3,5,17,25
843,14,Youth,Blue Collar,0.16580692395614124,False,4,5,14,23
844,60,Middle Age,Blue Collar,0.44532573170634104,False,4,4,17,25
845,32,Young Adult,Blue Collar,0.28710346659034747,False,4,4,9,17
846,42,Middle Age,White Collar,0.20515210248463084,False,5,4,18,27
847,35,Young Adult,White Collar,0.3569482999794101,False,2,4,20,26
848,37,Young Adult,Student,0.08720531597496316,False,3,5,16,24
849,42,Middle Age,Student,0.23791157291652001,False,1,3,15,19
850,78,Elderly,White Collar,0.2125906368597829,False,3,4,16,23
851,39,Young Adult,Retired,0.3380474712276761,False,3,4,11,18
852,34,Young Adult,White Collar,0.29052756084271986,False,5,3,13,21
853,59,Middle Age,White Collar,0.3479181328972756,False,4,4,13,21
854,49,Middle Age,Blue Collar,0.42219960770511694,False,2,3,18,23
855,31,Young Adult,Student,0.24249642318363557,False,3,4,20,27
856,47,Middle Age,Blue Collar,0.3024763373927353,False,3,5,10,18
857,49,Middle Age,Blue Collar,0.5685546252018754,False,4,5,12,21
858,65,Middle Age,Blue Collar,0.29393240112032726,False,3,3,14,20
859,5,Youth,Blue Collar,0.23718069472344744,True,3,4,14,21
860,28,Young Adult,Blue Collar,0.4348483136027772,False,3,4,19,26
861,31,Young Adult,Blue Collar,0.24766475341982122,False,5,5,12,22
862,28,Young Adult,Blue Collar,0.5915252921662858,False,4,4,19,27
863,22,Young Adult,Student,0.49414273786873564,False,3,4,14,21
864,89,Elderly,White Collar,0.19275092244199293,False,3,4,16,23
865,40,Young Adult,Student,0.21570858057122805,True,3,5,12,20
866,86,Elderly,Blue Collar,0.4548274324248505,False,2,4,18,24
867,61,Middle Age,White Collar,0.43203347294911104,False,3,4,13,20
868,42,Middle Age,Blue Collar,0.4727380263938699,False,3,4,17,24
869,62,Middle Age,White Collar,0.2538973946761992,False,1,3,14,18
870,15,Youth,Retired,0.28572136176326274,False,1,4,15,20
871,31,Young Adult,Blue Collar,0.2317922806044498,False,3,5,11,19
872,78,Elderly,White Collar,0.23320414628000993,False,2,4,13,19
873,61,Middle Age,Blue Collar,0.16973032592208812,False,1,4,12,17
874,57,Middle Age,White Collar,0.49151217411248727,False,3,3,16,22
875,58,Middle Age,Student,0.33195877515080124,True,3,4,15,22
876,8,Youth,Blue Collar,0.34270313402458813,False,3,5,15,23
877,87,Elderly,Blue Collar,0.47320746037150585,False,5,4,14,23
878,28,Young Adult,White Collar,0.057826174727944005,False,4,4,13,21
879,37,Young Adult,White Collar,0.3342823374545915,False,2,4,18,24
880,39,Young Adult,White Collar,0.5055663733930453,False,4,3,14,21
881,6,Youth,White Collar,0.10926771693672341,False,5,4,8,17
882,28,Young Adult,White Collar,0.47637186210417104,False,3,4,15,22
883,6,Youth,White Collar,0.3351520189164386,False,2,4,17,23
884,55,Middle Age,Student,0.31131126560378347,False,3,3,15,21
885,2,Youth,White Collar,0.31565145210422435,False,1,4,14,19
886,1,Youth,Student,0.13425930596426694,False,3,4,10,17
887,46,Middle Age,White Collar,0.04261251654027319,False,5,4,16,25
888,65,Middle Age,Student,0.44024925150934274,False,4,4,18,26
889,53,Middle Age,White Collar,0.1195934956640864,False,5,3,12,20
890,17,Youth,Student,0.2000779313230957,False,4,4,12,20
891,10,Youth,Blue Collar,0.7007817975708072,False,5,4,17,26
892,0,Youth,Blue Collar,0.2817555447671213,False,2,4,12,18
893,52,Middle Age,White Collar,0.34926511547555156,False,4,4,13,21
894,28,Young Adult,Student,0.18348662812958907,False,3,4,16,23
895,28,Young Adult,White Collar,0.5023166737897836,False,4,3,14,21
896,32,Young Adult,Blue Collar,0.06245007841002178,False,1,4,14,19
897,34,Young Adult,White Collar,0.4354437700393007,False,5,4,12,21
898,91,Elderly,Student,0.0920630148030118,False,3,4,20,27
899,79,Elderly,Blue Collar,0.6257518883853295,False,3,4,11,18
900,11,Youth,Blue Collar,0.37700811694720254,False,1,5,18,24
901,39,Young Adult,White Collar,0.1271719790497805,False,3,4,16,23
902,1,Youth,Blue Collar,0.27435287356315835,False,5,3,14,22
903,3,Youth,White Collar,0.38256661568693123,False,5,3,13,21
904,34,Young Adult,Blue Collar,0.17843961982715925,False,2,4,16,22
905,41,Middle Age,White Collar,0.2162905367743838,False,3,4,10,17
906,49,Middle Age,Blue Collar,0.5209740341645329,False,2,4,18,24
907,22,Young Adult,White Collar,0.279074004926693,False,4,5,11,20
908,22,Young Adult,White Collar,0.48498879957497276,False,3,5,22,30
909,57,Middle Age,Retired,0.3481128642195799,False,5,4,12,21
910,24,Young Adult,Student,0.37769730827879666,False,3,5,16,24
911,34,Young Adult,White Collar,0.45526763848906865,True,5,3,18,26
912,44,Middle Age,Blue Collar,0.564636774420852,False,4,4,16,24
913,2,Youth,Blue Collar,0.13525495524082082,True,3,4,21,28
914,49,Middle Age,Blue Collar,0.41890629703440113,False,4,4,12,20
915,82,Elderly,White Collar,0.6277239733678208,True,3,5,19,27
916,1,Youth,Blue Collar,0.42330626189328024,False,3,4,17,24
917,54,Middle Age,Blue Collar,0.3242865327317485,True,2,5,24,31
918,42,Middle Age,Student,0.5237323534287259,False,4,4,9,17
919,51,Middle Age,White Collar,0.6843643932117193,False,2,4,10,16
920,64,Middle Age,Student,0.35926527588984386,False,3,5,16,24
921,12,Youth,White Collar,0.3939614324212918,False,3,5,11,19
922,63,Middle Age,Blue Collar,0.3799956547644613,False,3,4,8,15
923,46,Middle Age,Student,0.08417433653931046,False,3,4,16,23
924,5,Youth,Student,0.43722711473977127,False,4,4,11,19
925,37,Young Adult,Blue Collar,0.09410779357588527,False,1,4,16,21
926,30,Young Adult,Blue Collar,0.3982612864989766,False,4,4,14,22
927,64,Middle Age,Retired,0.07765506645751091,False,3,5,18,26
928,73,Elderly,Blue Collar,0.12821245493162958,False,3,3,10,16
929,10,Youth,Student,0.21425064305656616,False,3,4,19,26
930,37,Young Adult,Blue Collar,0.18980885239554654,False,3,4,15,22
931,87,Elderly,White Collar,0.449549690409468,False,1,4,15,20
932,54,Middle Age,Blue Collar,0.23408313613509113,False,3,4,18,25
933,40,Young Adult,Blue Collar,0.10047468691113758,False,3,4,17,24
934,60,Middle Age,Student,0.1752910699720822,False,5,4,12,21
935,15,Youth,Blue Collar,0.31120624590899987,False,4,4,16,24
936,15,Youth,White Collar,0.30725814341699853,False,2,5,12,19
937,35,Young Adult,Student,0.31622983906163077,False,2,6,11,19
938,26,Young Adult,Student,0.4493230296578294,False,1,4,12,17
939,21,Young Adult,Blue Collar,0.4992607592612914,False,3,5,12,20
940,15,Youth,Blue Collar,0.37973287476095796,True,3,4,12,19
941,20,Young Adult,White Collar,0.25879512048478875,True,4,4,10,18
942,9,Youth,Blue Collar,0.21720650202910807,False,5,4,19,28
943,55,Middle Age,Retired,0.6337271424536701,False,3,3,15,21
944,7,Youth,Blue Collar,0.3024225452045582,False,4,4,12,20
945,60,Middle Age,White Collar,0.35324383153672906,False,5,5,13,23
946,44,Middle Age,Student,0.19600880118123296,False,3,4,19,26
947,11,Youth,Blue Collar,0.19460414633823603,False,4,4,14,22
948,35,Young Adult,White Collar,0.12016596269169015,False,4,4,15,23
949,56,Middle Age,Student,0.2881738348704263,False,4,5,11,20
950,44,Middle Age,White Collar,0.19451076843381124,False,3,4,17,24
951,12,Youth,Student,0.22190174670034968,False,3,4,14,21
952,10,Youth,Student,0.49244241405815076,False,5,5,15,25
953,73,Elderly,Blue Collar,0.08506599782258312,False,3,4,14,21
954,57,Middle Age,Student,0.17078468035505964,False,5,3,12,20
955,20,Young Adult,White Collar,0.3275299415979275,False,3,5,20,28
956,35,Young Adult,Blue Collar,0.3146017534698956,False,3,3,16,22
957,46,Middle Age,Blue Collar,0.5591300431761457,False,3,4,11,18
958,38,Young Adult,Blue Collar,0.05690746574113332,False,5,4,17,26
959,54,Middle Age,Retired,0.5215862971395819,False,2,4,16,22
960,49,Middle Age,White Collar,0.11091117446247269,False,3,4,22,29
961,23,Young Adult,Student,0.22652284530795472,False,3,5,14,22
962,57,Middle Age,White Collar,0.08232379528839835,False,3,4,15,22
963,63,Middle Age,Blue Collar,0.02033762111179792,False,3,4,21,28
964,25,Young Adult,Blue Collar,0.515099224706211,False,3,4,17,24
965,40,Young Adult,Student,0.1524295832997067,False,3,4,9,16
966,77,Elderly,White Collar,0.401561690342304,False,2,4,16,22
967,22,Young Adult,Blue Collar,0.1934741652155991,False,3,4,19,26
968,40,Young Adult,Blue Collar,0.5676055160091945,False,2,3,14,19
969,58,Middle Age,White Collar,0.207457529958512,False,3,4,14,21
970,57,Middle Age,Student,0.24303279275432918,False,2,4,17,23
971,1,Youth,Student,0.16867962259904035,False,2,5,17,24
972,9,Youth,Blue Collar,0.11978721348434995,False,2,3,11,16
973,9,Youth,Student,0.4281637369757693,False,2,5,17,24
974,33,Young Adult,Student,0.2805328520070296,False,3,5,17,25
975,48,Middle Age,Blue Collar,0.025530459181464824,False,4,3,17,24
976,28,Young Adult,Blue Collar,0.5758838933798938,True,5,3,20,28
977,32,Young Adult,Retired,0.24667491342653283,False,3,4,16,23
978,36,Young Adult,Student,0.12659141193795395,False,5,4,15,24
979,33,Young Adult,Blue Collar,0.07690526282307505,False,3,4,12,19
980,61,Middle Age,White Collar,0.13178659947560378,False,4,5,16,25
981,47,Middle Age,Blue Collar,0.34235225040309447,False,3,4,16,23
982,24,Young Adult,Retired,0.4422870444385288,True,4,4,12,20
983,98,Elderly,Student,0.22902080143355766,True,2,4,16,22
984,27,Young Adult,Student,0.8133424050014515,False,3,5,11,19
985,29,Young Adult,White Collar,0.20792342426577648,False,4,3,19,26
986,10,Youth,White Collar,0.26083444259376065,False,5,4,19,28
987,62,Middle Age,White Collar,0.10952628416623476,False,2,4,19,25
988,21,Young Adult,Blue Collar,0.25085125200039493,False,3,3,13,19
989,24,Young Adult,White Collar,0.46152626905013167,False,3,4,14,21
990,17,Youth,White Collar,0.6224521206393593,True,1,3,17,21
991,25,Young Adult,Blue Collar,0.3984798933684013,False,4,4,14,22
992,38,Young Adult,White Collar,0.058734322284688646,False,3,3,15,21
993,61,Middle Age,Student,0.09968586243360074,False,5,5,17,27
994,39,Young Adult,Blue Collar,0.05874538677015844,False,3,4,18,25
995,86,Elderly,White Collar,0.14049481279644285,False,2,4,15,21
996,8,Youth,White Collar,0.18135617969878268,False,3,4,8,15
997,89,Elderly,White Collar,0.12077322769540527,False,2,4,20,26
998,28,Young Adult,Blue Collar,0.3803905055871858,False,3,3,15,21
999,22,Young Adult,Student,0.11550874706878707,False,1,4,16,21
